101 101
#####################################################################################################
### #### #### #######################################################################################
#                                                                                                  ##
#                                                                                                  ##
#                                                                                                  ##
#                                                                                                  ##
#                                                                                                  ##
#                                                                                                  ##
#                                                                                                  ##
#                                                                                                  ##
#                                                                                                  ##
#                                                                                                  ##
#                                                                                                  ##
#                                                                                                  ##
#                                                                                                  ##
#                                                                                                  ##
#                                                                                                  ##
#                                                                                                  ##
#                                                                                                  ##
#                                                                                                  ##
#                                                                                                  ##
#                                                                                                  ##
#                                                                                                  ##
#                                                                                                  ##
#                                                                                                  ##
#                                                                                                  ##
#                                                                                                  ##
#                                                                                                  ##
#                                                                                                  ##
#                                                                                                  ##
#                                                                                                  ##
#                                                                                                  ##
#                                                                                                  ##
#                                                                                                  ##
#                                                                                                  ##
#                                                                                                  ##
#                                                                                                  ##
#                                                                                                  ##
#                                                                                                  ##
#                                                                                                  ##
#                                                                                                  ##
#                                                                                                  ##
#                                                                                                  ##
#                                                                                                  ##
#                                                                                                  ##
#                                                                                                  ##
#                                                                                                  ##
#                                                                                                  ##
#                                                                                                  ##
#                                                                                                  ##
#                                                                                                  ##
#                                                                                                  ##
#                                                                                                  ##
#                                                                                                  ##
#                                                                                                  ##
#                                                                                                  ##
#                                                                                                  ##
#                                                                                                  ##
#                                                                                                  ##
#                                                                                                  ##
#                                                                                                  ##
#                                                                                                  ##
#                                                                                                  ##
#                                                                                                  ##
#                                                                                                  ##
#                                                                                                  ##
#                                                                                                  ##
#                                                                                                  ##
#                                                                                                  ##
#                                                                                                  ##
#                                                                                                  ##
#                                                                                                  ##
#                                                                                                  ##
#                                                                                                  ##
#                                                                                                  ##
#                                                                                                  ##
#                                                                                                  ##
#                                                                                                  ##
#                                                                                                  ##
#                                                                                                  ##
#                                                                                                  ##
#                                                                                                  ##
#                                                                                                  ##
#                                                                                                  ##
#                                                                                                  ##
#                                                                                                  ##
#                                                                                                  ##
#                                                                                                  ##
#                                                                                                  ##
#                                                                                                  ##
#                                                                                                  ##
#                                                                                                  ##
#                                                                                                  ##
#                                                                                                  ##
#                                                                                                  ##
#                                                                                                  ##
#                                                                                                  ##
#                                                                                                  ##
#                                                                                                  ##
#                                                                                                  ##
#####################################################################################################